Name,Roll_no,Maths,Physics,Computer,Total
Hamza,1,73,74,79,226
Fatima,2,94,77,83,254
Hassan,3,91,82,88,261
Ayesha,4,72,76,87,235
Bilal,5,79,71,83,233
Zara,6,91,72,88,251
Saad,7,81,84,85,250
Hina,8,75,82,88,245
Imran,9,92,84,78,254
Mehwish,10,82,73,83,238
Daniyal,11,93,74,88,255
Noor,12,81,77,79,237
Hamza,13,77,65,85,227
Aleena,14,87,72,81,240
Fahad,15,76,84,88,248
Sana,16,91,71,77,239
Asad,17,91,72,79,242
Mahnoor,18,80,81,85,246
Usman,19,92,84,79,255
Amna,20,91,74,81,246
Zain,21,82,68,78,228
Maryam,22,78,81,89,248
Adnan,23,90,71,78,239
Laiba,24,72,78,78,228
Kashif,25,91,82,81,254
Nimra,26,86,83,78,247
Salman,27,91,72,80,243
Hira,28,83,66,83,232
Talha,29,79,83,86,248
Iqra,30,91,77,77,245
Waleed,31,95,80,85,260
Anum,32,92,80,81,253
Noman,33,91,70,79,240
Sehrish,34,93,72,85,250
Taha,35,93,77,89,259
Rabia,36,82,76,82,240
Junaid,37,94,77,83,254
Fiza,38,71,81,77,229
Ali,39,75,72,88,235
Kiran,40,89,73,82,244
Ahmed,41,71,68,84,223
Maira,42,72,71,78,221
Danish,43,72,75,81,228
Aimen,44,71,70,88,229
Farhan,45,87,68,78,233
Samina,46,81,78,78,237
Moiz,47,72,78,84,234
Sidra,48,70,76,79,225
Hammad,49,83,83,83,249
Alishba,50,75,82,88,245
Zeeshan,51,81,75,83,239
Mariya,52,79,75,86,240
Ibrahim,53,88,78,86,252
Mahira,54,83,66,79,228
Arsalan,55,85,72,85,242
Beenish,56,84,83,88,255
Rehan,57,93,82,81,256
Sadaf,58,81,77,78,236
Kamran,59,76,83,86,245
Shiza,60,92,76,86,254
Naveed,61,92,69,83,244
Tehreem,62,73,76,80,229
Rizwan,63,87,73,87,247
Sumbal,64,83,80,89,252
Umar,65,84,83,82,249
Humaira,66,92,75,80,247
Shahid,67,70,82,85,237
Arooba,68,93,68,84,245
Waqar,69,84,79,77,240
Maham,70,74,80,79,233
Obaid,71,79,67,81,227
Hafsa,72,83,78,83,244
Furqan,73,70,80,83,233
Nida,74,95,80,80,255
Irfan,75,86,71,88,245
Bushra,76,81,82,77,240
Tariq,77,93,83,82,258
Sanaullah,78,92,65,87,244
Hafeez,79,75,75,89,239
Mehwish,80,79,79,81,239
Sheraz,81,73,83,81,237
Shagufta,82,80,67,88,235
Jawad,83,86,66,86,238
Iqra,84,76,72,84,232
Mustafa,85,84,73,77,234
Nashit,86,84,69,81,234
Samina,87,84,73,88,245
Raheel,88,80,70,83,233
Sadia,89,80,66,81,227
Ayaz,90,85,68,78,231
Sehar,91,89,76,80,245
Afshan,92,81,73,79,233
Khurram,93,77,75,80,232
Muneeb,94,85,74,77,236
Farzana,95,74,75,86,235
Yasir,96,78,78,86,242
Lubna,97,78,76,86,240
Shahbaz,98,80,83,82,245
Rukhsar,99,95,69,89,253
Fahima,100,93,77,84,254
